##########################
#,,,,,,,,,,,,,,,,,,,,,,,,#                                                              
#,,,,,,,,,,,,,,,,,,,,,,,,#                                                             
#,,,,,hello,,(◕‿◕ ✿),,,,,#
#,,,,,,,,,,,,,,,,,,,,,,,,#
#,,,,,,,,,,,,,,,,,,,,,,,,#
#,,,,,,,,,,,,,,,,,,,,,,,,#
#,,,,,,,,,,,,,,,,,,,,,,,,#
#,,,,,,,,,,,,,,,,,,^,,,,,#,,,,,, (╯°□°）╯︵┻━┻
#,,,,,,,,,,,,,######,,,,,#
#,,,,,,,,,,,,,,,,,,,,,,,,#
#,,,,,,,,,,,,,,,,,,,,,,,,############################################################
#,,,,,,,,,,,,,,,,,,,,,,,,,,,,,,,,,,,,,,,,,,,,,,,,,,,,,,,,,,,,,,,,,,,,,,,,,,,,,,,,,,,#
#,,,,,,,,,,,,,,,,,,,,,,,,,,,,,,,,,,,,,,,,,,,,,,,,,,,,,,,,,,,,,,,,,,,,,,,,,,,,,,,,,,,#
#,,,,,,,,,,#,,,,,,,,,,,,,,,,,,,,,,,,,,,,,,,,,,,,,,,,,,,,,,,,,,,kevin,z,stuck,,,,,,,,#
#,,,,,,,,,,,,,,,,,,,,,,,,,,,,,,,,,,,,,,,,,,,,,,,,,,,,,,,,,,,,,,,,,,,,,,,,,,,,,,,,,,,#
#,,,,,,,,,,,,,,,,,,,,,,,,,,,,,,,,,,,,,,,,,,,,,,,,,,,,,,,,,,,,,,,,,,,,,,,,,,,,###,,###
#,,,,,,,,,,,,,,,,,,,,,,,,,,,,,,,,,,,,,,,,,,,,,,,,,,,,,,,,,,,,,,,,,,,,,,,,#,,,,,#,,,,#
#,,,,,##,,,,,,,,,,,,,,,,,,,,,,,,,,,,,,,,,,,,,,,,,,,,,,,,,,,,,,,,,,,,,#,,,,,,,,,#,,,,#
#,,,,,,,,,,,,,,,,,,,,,, ,,,,,,,,,,,,,,,,,,,,,,,,,,,,,,,,,,,,,,,,,##,,,,,,,,,,,,###,,#
#,,,,,,,,,,,,,,,,,,,,,,,,,,,,,,,,,,,,,,,,,,,,,,,,,,,,,,,,,,,###,,,,,,,,,,,,,,,,#,,,,#
#,,⚑,,,,,,,,^^^^^^^^^^^^^^^^,,,,,,,,,,,,,,,,,,,,,,,,,,,,###,,,,,,,,,,,,,,,,,,,,#,,,,#
########################################,,,,,,,,,,,,##,,,,,,,,,,,,,,,,,,,,,,,,,#,,###
,,,,#,,,,,,,,,,,,,,,,,,,,,,,,,,,,,,,,,,#,,,,,,,,,,,,#,#,,,,,,,,,,,,,,,,,,,,,,,,#,,,,#
,,,,#,,,,,,,,,,,,,,,,,,,,,,,,,,,,,,,,,,#,,,,,,,,,,,,#,,#,,,,,,,,,,,,,,,,,,,,,,,###,,#,,ಠ_ಠ
,,,,#,,,,,,,,,,,,,,,,,,,,,,,,,,,,,,,,,,#^^^^^^^^^^^^#,,,#,,,,,,,,,,,,,,,^^^^^^^#,,,⚐#
,,,,#,,,,,,,,,,,,,,,,,,,,,,,,,,,,,,,,,,##############,,,,#######################,,###
,,,,#,,,,,,,,,,,,,,,,,,,,,,,,,,,,,,,,,,,,,,,,,,,,,,,,,,,,,,,,,,,,,,,,,,,,,,,,,,,,,#
,,,,#,,,,,,,,,,,,,,,,,,,,,,,,,,,,,,,,,,,,,,,,,,,,,,,,,,,,,,,,,,,,,,,,,,,,,,,,,,,,,#
,,,,#,,,,,,,,,,,,,,,,,,,,,,,,,,,,,,,,,,,,,,,,,,,,,,,,,,,,,,,,,,,,,,,,,,,,,,,,,,,,,#
,,,,#,,,,,,,,,,,,,,,,,,,,,,,,,,,,,,,,,,,,,,,,,,,,,,,,,,,,ʕ •ᴥ•ʔ,,,,,,,,,,,,,,·····#
,,,,#,,,#,,,,,,,,,,,,,,,,,,,,,,,,,,,,,,,,,,,,,,,,,,,,,,,,,,,,,,,,,,,,,,,,,,,,·,,,·#
,,,,#,,,#,,,,,,,,,,,,,,,,,,,,,,,,············,,,,,,,,,,,,,,,,,,,,,,,,,,,,,,,··,,,·#
,,,,#,,,#,,,,,···,,,,,,,,,,,,,,,,·,,,,,,,,,,·,,,,,,,,,,,,,,,,,,,,,,,,,,,,,,,·,,,,·#
,,,,#,,,#,,,,,·,·,,,,,,,,,,,,,,,,·,,,,,,,,···,,,,,,,,,,,,,,,,,,,,,,,,,,,,,,,12345O#
,,,,#,,,#,,,,,·,·,,,,,,,,,,,,,,,,·,,,,,,,,·,,,,,,,,,,###,,,,,,,,,,,,,,,,,,,,,,,,,,#
,,,,#,,,#,,,,,1,·,,,,,12345O,,,,,·,,,,,,,,···,,,,,,,,,,,,,,,,,,,,,,,,,,,,,,,,,,,,,#
,,,,#,,,#,,,,,2,·,,,,,·^^^^·,,,,,1,,,,,,,,,,·,,,,,,,,,,,,,,,,,,,·········,,,,,,,,,#
,,,,#,,,#,,,,,3,·,,,,,······,,,,,2345O·······,,,,,,,,,,,,,,,,,,,·,,,,,,,·,,,,,,,,,#
,,,,#,,,#,,,,,45O,,,,,,,,,,,,,,,,,,,,,,,,,,,,,,,,,,,,,,,,,,,,,,,··O54321·,,,,,,,,,#
,,,,#,,,#,,,,,,,,,,,,,,,,,,,,,,,,,,,,,,,,,,,,,,,,,,,,,,,,,,,,,,,,,,,,,,,,,,,,,,,,,#
,,,,#,,,#^^^^^^^^^^^^^^^^^^^^^^^^^^^^^^^^^^^^^^^^^^^^^^^^^^^^^^^^^^^^^^^^^^^^^^^^^#
,,,,#,,,##########################################################################################
H,,,#,,,,,,,,,,,,,,,,,,,,,,,,,,,,,,,,,,#,,,,,,,,,,,,,,,,,,,,#,,,,,,,,,,,,,,,,,,,,,,,,,,,,,,,,,,,,#
,,,,#,,,,,,,,,,,,,,,,,,,,,,,,,,,,,,,,,,#,,,,,,,,,,,,,,,,,,,,#,,,,,,,,,,,,,,,,,,,,,,,,,,,,,,,,,,,,#
,,,,#,,,,,,,,,,,,,,,,,,,,,,,,,,,,,,,,,,#,,,,,,,,,,,,,,,,,,,,#,,,,,,,,,,,,,,,,,,,,,,,,,,,,,,,,,,,,#
#,,,####################,,,######,,,####,,,##################,,,,,,,,,,,,,,,,,,,,,,,,,,,,,,,,,,,,#
#,,,#,,,,,,,,,#,,,,,,,,,,,,#,,,,#,,,,,,,,,,,,,,,,,,#,,,,,,,,#,,,,,,,,,,,,,,,,,,,,,,,,,,,,,,,,,,,,#
#,,,%,,,,,,,,,#,,,,,,,,,,,,#,,,,#,,,,,,,,,,,,,,,,,,#,,,,,,,,#,,,,,,,,,,,,,,,,,,,,,,,,,,,,,,,,,,,,#
#,,,#,,,,,,,,,#,,,,,,,,,,,,#,,,,#,,,,,,,,,,,,,,,,,,#,,,,,,,,#,,,,,,,,,,,,,,,,,,,,,,,,,,,,,,,,,,,,#
#,,,#######,,,####,,,#######,,,,####,,,#############,,,######,,,,,,,,,,,,,,,,,,,,,,,,,,,,,,,,,,,,#
#,,,#,,,,,,,,,,,,,,,,,,,,,,,,,,,#,,,,,,,,,,,,,,,,,,,,,,,,,,,#,,,,,,,,,,,,,,,,,,,,######,,,,,,,,,,#
#,,,#,,,,,,,,,,,,,,,,,,,,,,,,,,,#,,,,,,,,,,,,,,,,,,,,,,,,,,,#,,,,,,,,,###,,,,,,,,,,,,,,,,,,,,,,,,#
#,,,#,,,,,,,,,,,,,,,,,,,,,,,,,,,#,,,,,,,,,,,,,,,,,,,,,,,,,,,#,,,,,,,,,,,,,,,,,,,,,,,,,,,,,,,,,,,,####
#,,,#########################################################,,,,,,,,,,,,,,,,,,,,,,,,,,,,,,,,,,,,,,,#
#,,,,,,,,,,,,,,,,,,,,,,,,,,,,,,,,,,,,,,,,,,,,,,,,,,,,,,,,,,,,,,#,,,,,,,,,,,,,,,,,,,,,,,,,,,,,,,,,,,,#
#,,,,,,,,,,,,,,,,,,,,,,,,,,,,,,,,,,,,,,,,,⚐,,,,,,,,,,,,,,,,,,,,#^^^^^^^^^^^^^^^^^^^^^^^^^^^^^^^^^#,,#
##################################################################################################,,#H
,,,,,,,,,,,,,,,,,,,,,,,,,,,,,,,,,,,,,,,,,,,,,,,,,,,,,,,,,,,,,,,,,,,,,,,,,,,,,,,,,,,,,,,,,,,,,,,,,#,,#
,,,,,,,,,,,,,,,,,,,,,,,,,,,,,,,,,,,,,,,,,,,,,,,,,,,,,,,,,,,,,,,,,,,,,,,,,,,,,,,,,,,,,,,,,,,,,,,,,#,,#
##################################################################################################,,#
#,,,,,,,,,,,,,,,,,,,,,,,,,,,,,,,,,,,,,,,,,,,,,,,,,,,,,,,,,,,,,,,,,,,,,,,,,,,,,,,,,,,,,,,,,,,,,,,,,,,#
#,,,,,,,,,,,,,,,,,,,,,,,,,,,,,,,,,,,,,,,,,,,,,,,,,,,,,,,,,,,,,,,,,,,,,,,,,,,,,,,,,,,,,,,,,,,,,,,,,,,#
#,,,,,,,,,,,,,,,,,,,,,,,,,,,,,,,,,,,,,,,,,,,,,,,,,,,,,,,,,,,,,,,,,,,,,,,,,,,,,,,,,,,,,,,,,,,,,,,,,,,#
#,,,,,,,,,,,,,,,,,,,,,,,,,,,,,,,,,,,,,,,,,,,,,,,,,,+,,,,,,,,,,,,,,,,,,,,,,,,,,,,,,,,,,,,,,,,,,,,#,,,#
#,,,,,,,,,,,,,,,,,,,,,,,,,,,,,,,,,,,,,,,,,,,,,,,,,,,,,,,,,,,,,,,,,,,,,,,,,,,,,,,,,,,,,,,,,,,,,,,,,,,#
#,,,,,,,,,,,,,,,,,,,,,,,,,,,,,,,,,,,,,,,,,,,,,,,,,,#,,,,,,,,,,,,,,,,,,,,,,,,,,,,,,,,,,,,,,,,,,,,,,,,#
#,,,,,,,,,,,,,,,,,,,,,,,,,,,,,,,,,,,,,,,,,,,,,,,,,,+,,,,,,,,,,,,,,,,,,,,,,,,,,,,,,,,,,,,,,,,,,,,,,,,#
#####################################################################################################



